7702781011116
7702781012625
7702781007607
7702781007997
7702781007584
7702781007614
7702781009731
7702781007782
7702781001520
7702781007232
7702781025137
7702781025120
7702781010362
7702781010355
7702781001681
7702781007553
7702781007577
7702781007355
7702781012687
7702781007348
7702781007591
7702781007560
7702781007478
7702781007515
7702781007508
7702781007485
7702781007461
7702781009113
7702781009120
7702781009137
7702781011079
7702781009106
7702781011086
7702781011109
7702781011123
7702781011482
7702781011499
7702781011505
7702781011512
7702781011529
7702781011536
7702781012656
7702781012663
7702781012670
