CÓDIGOS EAN 3 LEVEL HIGH SUMMER


7702781056629
7702781056636
7702781056643
7702781058579
7702781058586
7702781058593
7702781056490
7702781056506
7702781056513
7702781058524
7702781058531
7702781058548
7702781056575
7702781056582
7702781056599
7702781058623
7702781058630
7702781058647
7702781057626
7702781057633
7702781057640
7702781057374
7702781057381
7702781057398
7702781057404
7702781057329
7702781057336
7702781057343
7702781057350
7702781057428
7702781057435
7702781057442
7702781057459
7702781057220
7702781057237
7702781057244
7702781057251
7702781057077
7702781057084
7702781057091
7702781057107
7702781057725
7702781057732
7702781057749
7702781057756
7702781057527
7702781057534
7702781057541
7702781057558
7702781057770
7702781057787
7702781057794
7702781057800
7702781057879
7702781057886
7702781057893
7702781057909
7702781057824
7702781057831
7702781057848
7702781057855
7702781058227
7702781058234
7702781058241
7702781058258
7702781057176
7702781057183
7702781057190
7702781057206
7702781057923
7702781057930
7702781057947
7702781057954
